#File type:
Level

#Level name:
Level 3

#Level map layout:
WWWWWWWWWWWWWWWWWWW@
W-D--------------TW@
W-----------------W@
WWWW-----------D--W@
W-------------WWWWW@
W-r---------------W@
W-------------r---W@
W-----------------W@
W------           w@
W-----            w@
W----             w@
w        w   r  d w@
w     p  www    www@
w     wwww   r  d w@
w        w        w@
w        w ww     w@
w t      w t      w@
w                 w@
wwwwwwwwwwwwwwwwwww@

#Level direction layout:
rrrrrg
