#File type:
Level

#Level name:
Level 3

#Level map layout:
wwwwwwwwwwwwwwwwwww@
w  w     w        w@
w  w r   w  r     w@
w  wwww ww        w@
w   r    w        w@
w      d www      w@
w        w        w@
w t  d d w  t     w@
w   p    w        w@
wwwwwwwwwwwwwwwwwww@
W--------W--------W@
W--------W---R--D-W@
W--------WWW-R--WWW@
W--------W---R--D-W@
W--------W---R--R-W@
W--------W-WWR--R-W@
W-T------W-T------W@
W--------W--------W@
WWWWWWWWWWWWWUWWVWW@

#Level direction layout:
rrrrrrrrrrruug