#File type:
Level

#Level name:
PushRock

#Level map layout:
WWWWWWWWWWWWWWWWWWW@
WWWWWWWWWWWWWWWWWWW@
WWWWWWWWWWWWWWWWWWW@
WWWWWWWWWWWWWDWWWWW@
WWWWW-R--------WWWW@
WWWWW-R--------WWWW@
WWWWW-R--------WWWW@
WWWWW-R--------WWWW@
WWWWW-R--------WWWW@
wwwwT-R--------wwww@
WWWWW-R-----W--WWWW@
WWWWW-R-----TWWWWWW@
WWWWW-R--------WWWW@
WWWWW-R--------WWWW@
WWWWW-P--------WWWW@
WWWWWWWWWWWWWWWWWWW@
WWWWWWWWWWWWWOWWWWW@
WWWWWWWWWWWWWWWWWWW@
WWWWWWWWWWWWWWWWWWW@

#Level direction layout:
ddddddddddddg