#File type:
Level

#Level name:
PushRock

#Level map layout:
WWWWWWWWWWWWWWWWWWW@
WWWWWWWWWWWWWWWWWWW@
WWWWWWWWWWWWWWWWWWW@
WWWWWWWWWWWWWDWWWWW@
WWWWW----------WWWW@
WWWWW----------WWWW@
WWWWW-R--------WWWW@
WWWWW----V-----WWWW@
WWWWW-R--P-----WWWW@
wwwwW-R--T-----wwww@
WWWWW-R--------WWWW@
WWWWW----T---WWWWWW@
WWWWW----R---WWWWWW@
WWWWW----U-----WWWW@
WWWWW----------WWWW@
WWWWWWWWWWWWWWWWWWW@
WWWWWWWWWWWWWOWWWWW@
WWWWWWWWWWWWWWWWWWW@
WWWWWWWWWWWWWWWWWWW@

#Level direction layout:
ddddddludg