#File type:
Level

#Level name:
PushRock

#Level map layout:
WWWWWWWWWWWWWWWWWWW@
WWWWWWWWWWWWWWWWWWW@
WWWWWWWWWWWWWWWWWWW@
WWWWWWWWWWWWWDWWWWW@
WWWWW----------WWWW@
WWWWW----------WWWW@
WWWWW-R--------WWWW@
WWWWW----------WWWW@
WWWWW-R--------WWWW@
wwwwT-R--------wwww@
WWWWW-R-----W--WWWW@
WWWWW-R-----TWWWWWW@
WWWWW----------WWWW@
WWWWW--W-------WWWW@
WWWWW-PW-------WWWW@
WWWWWWWWWWWWWWWWWWW@
WWWWWWWWWWWWWOWWWWW@
WWWWWWWWWWWWWWWWWWW@
WWWWWWWWWWWWWWWWWWW@

#Level direction layout:
dddddddg