#Map layout:
wwwwwwwwwwwwwwwwwww@
w  w     w        w@
w  w r   w  r     w@
w  wwww ww        w@
w   r    w        w@
w        www      w@
w        w        w@
w        w        w@
w        w        w@
wwwwwwwwwwwwwwwwwww@
W--------W---T----W@
W--------W------ -W@
W--------WWW----WWW@
W--------W-   --D-W@
W--------W--------W@
W--------W-WVR----W@
W- ------W-T------W@
W--------W---R--P-W@
WWWWWWWWWWWWWUWWWWW@

#Direction layout:
rrrrrrru
